BBBBBBBBBBBBBBBBBB
BB..............BB
B..........BB....B
B..........BB....B
B................B
B................B
B...BBB..........B
B................B
B................B
B........1.......B
B................B
B................B
B................B
B................B
B..........BBBB..B
B................B
BB..............BB
BBBBBBBBBBBBBBBBBB