BBBBBBBBBBBBBBBBBB
BB..............BB
B.1..............B
B................B
B................B
B.....BB..BB.....B
B.....B....B.....B
B.......BB.......B
B.......BB.......B
B.....B....B.....B
B.....BB..BB.....B
B................B
B................B
B................B
B................B
B................B
BB..............BB
BBBBBBBBBBBBBBBBBB