BBBBBBBBBBBBBBBBBB
B................B
B.1..............B
B................B
B................B
B................B
B................B
B................B
B................B
B................B
B................B
B................B
B................B
B................B
B................B
B................B
B................B
BBBBBBBBBBBBBBBBBB